
NO ./xpm_files/eagle.xpm
SO ./xpm_files/redbrick.xpm
WE ./xpm_files/wood.xpm
EA ./xpm_files/wall.xpm

        F 50,100,180
        C 0,255,50

    11111111111111111111111
    10000000001100000000001
    10110000011100000000001
    10010000000000000000001
11111111101100E001110000001
100000000011000001110111111
111101111111110111000000101
111101111111011101010010001
110000001101010111000000001
100000000000001100000010001
100000000000000011010110001
1100001111111101111110001111
11110111 1110101  1011110001
11111111 1111111  1111111111