
NO ./xpm_files/eagle.xpm
SO ./xpm_files/redbrick.xpm
WE ./xpm_files/wood.xpm
EA ./xpm_files/purplestone.xpm

        F 220,100,0
        C 225,30,0

1111111111111111111111111111
     10000000001100000000001
     10110001111100000000001
     100100011  100000000001
 111111100001111111110000001
 100000000011000001110111111
 1N1101110000010111000000101
 111111111111111111111111111
