
NO ./xpm_files/eagle.xpm
SO ./xpm_files/redbrick.xpm
WE ./xpm_files/wood.xpm
EA ./xpm_files/bluestone.xpm

        F 50,100,180
        C 0,255,50

11111111111111111111111111111111111
10000000000000000000000000000000001
10000000000000000000000000000000001
10000000000000000000000000000000001
10000000000000000000000000000000001
10000000000000000000000000000000001
10000000000000000000000000000000001
10000000000000000000000000000000001
10000000000000000000000000000000001
10000000000000000000000000000000001
10000000000000000000000000000000001
10000000000000000000000000000000001
10000000000000000000000000000000001
10000000000000000000000000000000001
10000000000000000000000000000000001
100000000000000000N0000000000000001
11111111111111111111111111111111111